3 3 0 0 2 2
1 2 3
4 5 6
7 8 9
4 4 0 0 3 3
2 2 2 2
3 1 4 3
5 6 7 8
1 2 3 4
10 7 0 0 9 6
3 1 4 2 5 7 6
6 2 8 3 1 5 4
7 6 3 9 2 8 1
2 4 7 5 6 1 3
8 3 1 4 7 9 6
4 5 6 7 8 2 9
9 8 7 6 5 4 3
1 7 5 3 9 2 8
6 4 3 8 1 7 5
3 2 8 8 2 9 3
0
